   ############
S  #          #
   # G        #
   #          #
   ######   ###
   #          #
   #          #
   #          #
   ####   #####

