S   #  #####
    #  #   #
    #  # G #
    #      #
    #      #
    ########

